11111111
10000001
1VECP001
11111111