1111111111111111111111111111111111
1000000000000000C00000000000100001
1000000V000000000000000000E0100001
1000000000000000000000000000111111
1000000000000000C00000000000000001
100000C000000000000000000000000P01
1000000C00000C00000000000000000001
1000000000000000000000000000000001
1000000000000000000000000000000001
1000000000000000C00000000000000001
100000C000000000000000000000000001
1000000000000C00000000000000000001
1000000000000000C00000000000000001
100000C000000000000000000000000001
1111111111111111111111111111111111