1111111111111111111111111111111111
1000000000000000C00000000000100001
100000000000000000000000E000100001
1000000000000000000000000000111111
1000000000000000C00000000000000001
100000C000000000000000000000000001
1000000000000C00000000000000000001
1000000000000000000000000000000001
1000000000000000000000000000000001
1000000000000000C00000000000000001
100000C000000000000000000000000001
1000000000000C00000000000000000001
1000000000000000C00000000000P00001
100000C000000000000000000000000001
1111111111111111111111111111111111